1111111111111111111111
100000000000000C111111
1010010100100000101001
1010010010101010001001
1P0000000C00CC00000001
1010000000000C00001001
1000010000F0000F001001
1000010010101000000001
100001C000F00010001001
1010010010101010001001
1000000000E00000000F01
1111111111111111111111